+++++++++++++++++++++++++++
+    +++++ +++++++++ ++ +++
+    +   + +       +++   ++
+    +A  +                +
++++++  A+++       +++   ++
++++  A A +++++++++++++ +++
++++ + ++ +++ ++++ ++++ +++
++   + ++ ++        ++   ++
+  A  A  0                +
+++++++++++++++   ++++   ++
+             +++++  ++ +++
+++ ++  ++++++++++ ++++ +++
++   +  +      ++   ++   ++
+       +                 +
++   ++++      ++   ++   ++
+++ +++        +++ ++++ +++
+++ +++        + + +      +
++   ++        +++ ++++++++
+              ++        ++
++   ++++++++++++        ++
+++ ++          +++++++++++
+++ +++++++++++  ++++++++ +
++   ++       ++++ aa a +++
+                        ++
++   ++       +++    aa a++
+++ +++++++++++++++++++++++
+++++++++++++++++++++++++++
