++++++++++++
+a   +     +++
+a   + A  A  +
+a   +A+ ++  +
+a   a 0 ++  +
+a   +++  A ++
+++++++++  A +
       +   A +
       +     +
       +++++++