    +++++
    +   +
    +A  +
  +++  A++
  +  A A +
+++ + ++ +   ++++++
+   + ++ +++++  aa+
+ A  A          aa+
+++++ +++ +0++  aa+
    +     +++++++++
    +++++++