################################
# ###  ### #####               #
# # #  # # #   #               #
# # #  # # #   #               #
# # #### # # $ #               #
# #      # ## ##               #
# # $..  # ##.##               #
### #$.$ ###   #               #
##@            #               #
### #### ###   #               #
######## #######               #
#     ## ##                    #
#     #   #                    #
#     #   #                    #
#     #   #                    #
#     ##.##                    #
#     ## #################     #
#     # $ ## $.##   ##   #     #
#     #            $ .   #     #
#     #   ##.$ ##   ##   #     #
#     ## ######### #### ##     #
#      # #####  ## #### #####  #
#      #  #  #  ##.   #     ####
#     #  $$  #  #...  # $$ $  ##
#     # $ # $#  ##.   #$# ##  ##
#     #. ### #####.....   ##  ##
#     #    . ..###.   # #  $ ###
#     ##     ########## ##$ $ ##
#     ########  #### $  $ $ $ ##
#                  #    #     ##
#                  #############
################################
