################################
##############  #####          #
###.   #     ####.  #          #
## .   # $  $    $ $#          #
###.   #$# ##  ##  .#          #
###.   .   ##  ### ##          #
###.   ###  $ #### #######     #
###########  $ ## $.##.  #     #
#        #   $        $ $#     #
#        #     ##.$ ##  .#     #
#        ############## ##     #
#                    ## ##     #
#                    # $.#     #
#                    #   #     #
#                    #.$ #     #
#                    ## ##     #
#           ######### # ##     #
#          ##..## $.##   #     #
#          # $$       .$ #     #
#          #   ##.$ ###  #     #
#           ###### #### ##     #
#               ## #### ########
#               #   ##       ###
#               #   ###### # ###
#               #   #    # # ###
#       ####    ##.##    #.   ##
#       #  #    ## ##    #.   ##
#     ### $###### $ #    ### ###
#     #.            #    # $$###
#     #  .$  ####   #    #@  ###
#     ########  #####    #######
################################
