###########################
#      ###      ###########
#      # ####   ## #### ###
#      #    #   #       @##
#      # #$ #   ## $.$# ###
#      # $. #    #  ..$ # #
#      # .. #    #      # #
#      # $  #    # #### # #
#      #    #    # #  # # #
#      # ####    # #  # # #
#      # #       # #  ### #
#     ## ######### #      #
#     #   ##   ###. #     #
#     #   . $     $ #     #
#     #   ##   ##   #     #
#     ## ######### ##     #
######## #####  ## ##     #
###.   #     ####   #     #
##..   # $$ $       #     #
###.   #$# ##  ## $ #     #
###.....   ##  ### ##     #
###.   # #  $ ####.##     #
######## ##$ $ ##   #     #
##### $  $ $ $ ##   #     #
#   #    #     ##   #     #
#   #################     #
###########################
