################################
#                    ######    #
#                    ##  @#    #
#                    ##$$ #    #
#                    ## ###    #
#                    #   .#    #
#                    #   .#    #
#                    ## # #    #
#                    ## # ######
#                    ##       ##
#                    ####### ###
#                     ###### ###
#                    #   ## $.##
#                    #.$      ##
#                    ##  ##.$ ##
#                    ## #### ###
####################### #### ###
##.  ## $.##   ##   ## $.##.  ##
##$ $         $ .          $ $##
##  .##.$ ##   ##   ##.$ ##  .##
### #### ######### #### #### ###
### #### #####  ## #### #### ###
###.   #     #####  ##   ##   ##
## .   # $  $  ##  $        $ ##
###.   #$# ##  ## $$ # $ ## .###
###.   .   ##  ## ..### ## # ###
###.   ###  $ ### #####.## # ###
###########  $ ## #  #   ##   ##
#        #   $    #  #     .$ ##
#        #     ##.#  #   ###  ##
#        ##########  ###########
################################
