################################
##########                     #
##  @###. #                    #
## $.## $ #                    #
##.$ ##   #                    #
### #### ##                    #
# # #### #######     ###########
##   ## $.##.  #     #  ###  ###
##.$        $ $#     # $.   $.##
###  ##.$ ##  .#     #   ##   ##
### ######### ##     ## # ## # #
### ##     ## ## ###### #### ###
##   #     #.  ##   ##.  ## $.##
## $ #     #$ $  .$   $ $     ##
## .##     #  .###  ##  .##.$ ##
# # ##     ## #### #### #### ###
### ##     ## #### #### #### ###
##.  #     #   ##   ##   ##   ##
##$ $#     #  $ .        . $  ##
##  .#     #   ##   ##   ##   ##
######     ## ######### #### ###
#     ####### ##      # #### # #
#     #.  ##   #      #      # #
#     #$ $     #      # $#$  # #
#     #  .##   #      # $  $## #
#     ## ####.##      ### $ #  #
#     ## #### ######### $ # ####
#     # $.## $ ##...  # #  $  ##
#     #        ###..      $   ##
#     #.$ ##   ##...  ##########
#     #################        #
################################
