################################
#          ##################  #
#          # $.###.   #     ####
#          #      .   # $  $  ##
#          #.$ ###.   #$# ##  ##
#          #######.   .   ##  ##
###########     ##.   ###  $ ###
##.  ##   #     ##########  $ ##
##$ $   $ #             #   $ ##
##  .## .##             #     ##
###### # ##             #### ###
#     ## ## ################ ###
#     #  ###   ## $.##   ##   ##
#     # $.  .$          $ .   ##
#     #   ###  ##.$ ##   ##   ##
#     ## # ############ ########
###### # #           ##  ##    #
##  ###  ##          # $$.#    #
## $.   $.#          #  $.######
##   ## $.#          ##      .##
### # #####          ####### ###
### ######################## ###
##       ###   ## $.##.  ## $.##
###### # ### $        $ $     ##
#    # # ### .###.$ ##  .##.$ ##
#    #.   # # #### #### #### ###
#    #.   ### # ## #### #### ###
#    ### ####. ##.  ##   ##   ##
#    # $$### $   $ $     . $  ##
#    #@  ###   ##  .##   ##   ##
#    ###########################
################################
