######################
#    #####           #
#    #   ##          #
#    #$   #          #
#  ###  $##          #
#  #  $ $ #          #
#### # ## ######     #
##   # ## ##   #     #
## $  $        #     #
#########.##   #     #
#       #.###.##     #
#       #.### ###### #
#       #.## $ ###. ##
#       #.        $ ##
#       #.##   ##   ##
#       ##### #### ###
#     ####  # #### ###
#     #   ##   ## $.##
#     #$$   .$ ##.$ ##
#     #..####  ##@  ##
#     #### ###########
######################
