################################
############### #####     ######
##  @##.  ###. ##.  #     #.  ##
## $.##$ $   $   $ $#     #$ $##
##.$ ##  .##   ##  .#     #  .##
### #### ######### ##     ## ###
### # ## ##     ## ######  # ###
###. ## $.#     #.  ###. ##   ##
## $      #     #$ $   $   .$ ##
##   ##.$ #     #  .##   ###  ##
### #######     ####### #### ###
# # ##               ## #### # #
##   #               #.  ###. ##
##.$ #               #$ $   $ ##
###  #               #  .##   ##
######               ## #### ###
#     ########## ###### #### ###
#     # $.## $.##   ##.  ##  ###
#     #          .$   $ $   $.##
#     #.$ ##.$ ###  ##  .##   ##
#     ## ######### #### ###### #
######## ##  ##### #### #####  #
##   ##   #  #.###.   #     ####
##      $ #  #    .   # $  $  ##
## $ ## .##  # ###.   #$# ##  ##
### ## # ##### ###.   .   ##  ##
###.#### ###.. ###.   ###  $ ###
##   ## $.# $$ ###########  $ ##
##          $  #        #   $ ##
##   ##.$ ##  ##        #     ##
################        ########
################################
