################################
##############  #####          #
###.   #     ####.  #          #
## .   # $  $    $ $#          #
###.   #$# ##  ##  .#          #
###.   .   ##  ######          #
###.   ###  $ ##     ###########
###########  $ #     # $.## $.##
#        #   $ #     #        ##
#        #     #     #.$ ##.$ ##
#        #### ##     ## ########
#     ####### ##      # ##     #
#     # $.## $.#     #   #     #
#     #        #     #.$ #     #
#     #.$ ##.$ #     ##  #     #
#     ## #### ##     ## ##     #
#     ## # ## ######### ########
#     ##. ## $.##.  ##.  ##  ###
#     # $        $ $  $ $   $.##
#     #   ##.$ ##  .##  .##   ##
#     ############ #### ###### #
#               ## #### ########
#               #   ##       ###
#               #   ###### # ###
#               #   #    # # ###
#               ##.##    #.   ##
#          ####### ##    #.   ##
#          # $.## $ #    ### ###
#          #        #    # $$###
#          #.$ ##   #    #@  ###
#          ##########    #######
################################
