################################
#                    ######    #
#                    ##  @#    #
#                    ##$$ #    #
#                    ## ###    #
#                    #   .#    #
#                    #   .#    #
#                    ## # #    #
#                    ## # ######
#                    ##       ##
#                    ####### ###
#                    #### ## ###
#                    ##. ##   ##
#                    # $    $ ##
#                    #   ## .###
#                    ## ## #####
#     ################# ##     #
#     #.  ##.  ##   ##   #     #
#     #$ $  $ $    $ .   #     #
#     #  .##  .##   ##   #     #
#     ## #### ############     #
#      # #### #                #
#      #      #                #
#      # $#$  #                #
#      # $  $##                #
#      ### $ #                 #
######## $ # ###               #
##...  # #  $  #               #
###..      $   #               #
##...  #########               #
########                       #
################################
