###########################
#      ##############     #
######## ###   ##   #     #
##                  #     #
#####  $ ###   ##   #     #
#   # .. ####.####.##     #
#   # .$ #### #### ##     #
##### $# ### $ ## $ #     #
##                  #     #
########@###   ##   #     #
#      ###### #### ##     #
#           # #### ########
#          #   ##   ##   ##
#          #.$      . $  ##
#          ##  ##   ##   ##
#          ## #### ########
#          ## #### #####  #
#          ##.   #     ####
#          #..   # $$ $  ##
#          ##.   #$# ##  ##
#          ##....    ##  ##
#          ##.   # #  $ ###
#          ####### ##$ $ ##
#          #### $  $ $ $ ##
#             #    #     ##
#             #############
###########################
