################################
################ ######### #####
##  @##.  ##.  ##   ##.  ##   ##
## $.##$ $  $ $  .$   $ $  .$ ##
##.$ ##  .##  .###  ##  .###  ##
### #### ######### #### #### ###
### #### ##     ## #### #### ###
##.  ## $.#     #.  ##.  ## $.##
##$ $     #     #$ $  $ $     ##
##  .##.$ #     #  .##  .##.$ ##
### #### ##     ####### #### ###
### #### #######     ## #### ###
##  ###.  ##.  #     #.  ##  ###
## $.  $ $  $ $#     #$ $   $.##
##   ##  .##  .#     #  .##   ##
### # ## #######     ## ###### #
### #### ##  ##########  ##    #
## $.##.  #  #.## $.## $$.#    #
##     $ $#  #          $.######
##.$ ##  .#  # ##.$ ###      .##
######## ##### ############# ###
#     ## ###.. #      ###### # #
#     #   # $$ #      #      # #
#     # $   $  #      # $#$  # #
#     # .###  ##      # $  $## #
#      # #### ##      ### $ #  #
#      # #### ######### $ # ####
#     #   ## $.##...  # #  $  ##
#     #.$      ###..      $   ##
#     ##  ##.$ ##...  ##########
#     #################        #
################################
