################################
#               #############  #
#               ##.   #     ####
#               # .   # $  $  ##
#               ##.   #$# ##  ##
#               ##.   .   ##  ##
######          ##.   ###  $ ###
## $.#          ##########  $ ##
##   #                  #   $ ##
##.$ #                  #     ##
### ##                  #### ###
### ######################## ###
##.  ##  ### $.## $.## $.## $.##
##$ $   $.                    ##
##  .##   ##.$ ##.$ ##.$ ##.$ ##
### #### # ## #### #### ########
### #### #### #### #### ##     #
##   ##   ##   ##.  ## $.#     #
##   . $         $ $     #     #
##   ##   ## $ ##  .##.$ #     #
### ######### ######### ##     #
### #########.##     ## #      #
##       ###   #     ##. #     #
###### # ###   #     # $ #     #
#    # # ###   #     #   #     #
#    #.   ######     ## ##     #
#    #.   #          ## #      #
#    ### ##          ##. #     #
#    # $$##          # $ #     #
#    #@  ##          #   #     #
#    ######          #####     #
################################
