################################
######                         #
##  @#                         #
## $.#                         #
##.$ #                         #
### ##                         #
### ############               #
##.  ##.  ##  ##               #
##$ $  $ $   $.#               #
##  .##  .##   #               #
############# #                #
#          ## #######          #
#          #   ##  ##          #
#          # $    $.#          #
#          # .###   #          #
#           # #### #   ####    #
# ########### #### ##  #  #    #
##   ##   ##   ## $.#### $######
##.$      . $         .       ##
###  ##   ##   ##.$ ##  .$  ####
### #### #### #### ##########  #
### #### #### #### ##########  #
##   ##.$ ##  ####.   #     ####
## $ ##.$    $.   .   # $  $  ##
## .####  ##   ###.   #$# ##  ##
# # ## # # ## # ##.   .   ##  ##
# # ## # ## # ####.   ###  $ ###
##   ##   ##   ###########  $ ##
##.$   .$   .$ #        #   $ ##
###  ###  ###  #        #     ##
################        ########
################################
