######################
#          ###########
#          # $.##.  ##
#          #     $$ ##
#          #.$ ## .@##
#          ## ########
#### ##    ## ###### #
## $$.#    #.  ###. ##
##  $.######$ $   $ ##
###      .##  .##   ##
######## #### #### ###
#      # #### # ## # #
#      #      # ##. ##
#      # $#$  # # $ ##
#      # $  $## #   ##
#      ### $ #  ######
######## $ # ###     #
##...  # #  $  #     #
###..      $   #     #
##...  #########     #
########             #
######################
