################################
#       #############          #
#       # ##  ###.  #          #
#       #    $.  $ $#          #
#       # ##   ##  .#          #
######### ##### ## ##          #
##@ #..   #     ## #           #
## $#  ## #     ##. #          #
## $      #     # $ #          #
#####  ####     #   #          #
###########     ## ##          #
#          ####### #############
#          #.  ##.  ##   ##   ##
#          #$ $  $ $     . $  ##
#          #  .##  .##   ##   ##
#          ## #### ######### ###
############# #### ##    ### # #
## $.##.  ##   ##   #    #   ###
##     $ $    $ .   #    #$   ##
##.$ ##  .##   ##   #  ###  $###
### ######### #######  #  $ $ ##
### ##  ##### ##  ###### # ## ##
## $.#  #.##   #  #.##   # ## ##
##   #  #      #  #    $  $   ##
##.$ #  # ##   #  # #########.##
### ##### ###.##### #       #.##
# # ###.. ### ###.. #       #.##
##   # $$ ## $ # $$ #       #.##
##.$   $  ##     $  #       #.##
###  ##  ###   ##  ##       #.##
#####################       ####
################################
