################################
#          ##################  #
#          #.  ###.   #     ####
#          #$ $   .   # $  $  ##
#          #  .###.   #$# ##  ##
#          ## ####.   .   ##  ##
#          ## ####.   ###  $ ###
#          #.  ###########  $ ##
#          #$ $#        #   $ ##
#          #  .#        #     ##
#          ## ##        #### ###
############# ##     ####### ###
## $.##.  ## $.#     #   ##   ##
##     $ $     #     #   . $  ##
##.$ ##  .##.$ #     #   ##   ##
### #### #######     ## #### ###
# # #### #           ## #### ###
##   ##   ############   ##.  ##
##.$   $$              $   $ $##
###  ##..#### $.$# ### .###  .##
### ######  #  ..$ #  # ########
### ####### #      # ## ##     #
##       ## ######## #.  #     #
###### # ##          #$ $#     #
#    # # ##          #  .#     #
#    #.   #          ## ##     #
#    #.   #     ####### ##     #
#    ### ##     #   ##   #     #
#    # $$##     #   . $  #     #
#    #@  ##     #   ##   #     #
#    ######     ##########     #
################################
