################################
#       ########          ######
#       # ##  ##          # $.##
#       #    $.#          #   ##
#       # ##   #          #.$ ##
######### ### #           ## ###
##@ #..   ### # ############ # #
## $#  ## ###. ##.  ## $.###. ##
## $      ## $   $ $        $ ##
#####  #####   ##  .##.$ ##   ##
############# #### #### #### ###
# ########### #### #### #### ###
##   ##.  ###  ##  ###.  ## $.##
##.$   $ $##  $   $.  $ $     ##
###  ##  .## $$ #   ##  .##.$ ##
### #### ### ..### # ## #### ###
### #### ### ##### #### #### ###
##.  ##  ### #  #.  ##   ##   ##
##$ $   $.   #  #$ $     . $  ##
##  .##   ##.#  #  .##   ##   ##
### #### # ###  ## #### ########
### #### ###### ## #### #####  #
##   ##   ##   ###.   #     ####
##  $ .     $$    .   # $  $  ##
##   ##   ##..####.   #$# ##  ##
### #### ###### ##.   .   ##  ##
### #### #########.   ###  $ ###
## $.## $.## $.###########  $ ##
##             #        #   $ ##
##.$ ##.$ ##.$ #        #     ##
################        ########
################################
