################################
######                         #
##  @#                         #
## $.#                         #
##.$ #                         #
### ##                         #
### ################ ###########
##.$ ##  ###.$ ##   ##   ##   ##
##.$    $.##.$   $$      . $  ##
###  ##   ###  ##..###   ##   ##
# # # ## #  # # #### ## #### ###
### # ## #### ######### #### ###
##   ##  ###   ##   ##   ##   ##
##$$    $.     . $       . $  ##
##..###   ##   ##   ##   ##   ##
##### ## # ################# ###
######## ##              ### # #
## $.##   #              #   ###
##        #              #$   ##
##.$ ##   #            ###  $###
########.##  ####      #  $ $ ##
#     ## ##  #  #    ### # ## ##
#     # $ #### $######   # ## ##
#     #     .          $  $   ##
#     #   ##  .$  ###########.##
#     #############         #.##
#                           #.##
#                           #.##
#                           #.##
#                           #.##
#                           ####
################################
