################################
#    #####                     #
#    #   ##                    #
#    #$   #                    #
#  ###  $##                    #
#  #  $ $ #                    #
#### # ## #                    #
##   # ## #                    #
## $  $   #                    #
#########.#                    #
#       #.#                    #
#       #.# ############# ######
#       #.###..##   ##   ##   ##
#       #.   $$       $$    $ ##
#       #.##   ##   ##..### .###
#       ### # ####.######  # ###
#     ####### #### ######### ###
#     # $.##  ### $ ##.$ ## $.##
#     #      $.     ##.$      ##
#     #.$ ##   ##   ###  ##.$ ##
#     ## #### # ## ## # # ## ###
#     ## #### ## # #### #### ###
#     #.  ##.$ ##   ##   ##   ##
#     #$ $##.$   .$      . $  ##
#     #  .###  ###  ##   ##   ##
#     ## ## # # ####### #### ###
######## #### ## ###### #### ###
##   ##   ## $.###..##.  ## $.##
##  $ .           $$  $ $##.$ ##
##   ##   ##.$ ##   ##  .##@  ##
################ ###############
################################
