###########################
#                ###  ### #
#                # #  # # #
#                # #  # # #
#                # #### # #
#                #      # #
#                # $..  # #
#               ## #$.$ ###
#               #@       ##
#               ## #### ###
#               ## #### ###
#               ## #### ###
#               #   ##   ##
#               #  $ .   ##
#               #   ##   ##
#               ## #### ###
##############  ## #### ###
###.   #     ####   ##   ##
##...  # $$ $      $ .   ##
###.   #$# ##  ##   ##   ##
###.....   ##  ############
###.   # #  $ ##          #
######## ##$ $ #          #
##### $  $ $ $ #          #
#   #    #     #          #
#   ############          #
###########################
