################################
#               ################
#               # $.##.  ##.  ##
#               #     $ $  $$ ##
#               #.$ ##  .## .@##
#               ## #############
#####  ########### ##          #
###. ##   ## $.##   #          #
## $   .$         $ #          #
##   ###  ##.$ ## .##          #
### #### #### ## ####          #
### #### #### ##               #
## $.##.  ##  ##               #
##     $ $   $.#               #
##.$ ##  .##   #               #
######## #### #                #
#    ### #  # #######          #
#    #   ###   ## $.#          #
#    #$     .$      #          #
#  ###  $####  ##.$ #          #
#  #  $ $ ### #### ##          #
#### # ## ### #### #######     #
##   # ## ##.  ##   ##   #     #
## $  $     $ $          #     #
#########.##  .## $ ## $ #     #
#       #.### #### #### ##     #
#       #.### ####.####.## #####
#       #.##  ###   ##   ##   ##
#       #.   $.            .$ ##
#       #.##   ##   ##   ###  ##
#       ####### ################
################################
