######################
#    #####           #
#    #   ##          #
#    #$   #          #
#  ###  $##          #
#  #  $ $ #  ####    #
#### # ## #  #  #    #
##   # ## #### $######
## $  $     .       ##
#########.##  .$  ####
#       #.#########  #
#       #.########## #
#       #.##  ####. ##
#       #.   $.   $ ##
#       #.##   ##   ##
#       ##### # ## ###
############# #### ###
##   ##   ## $.## $.##
##  $ .        ##.$ ##
##   ##   ##.$ ##@  ##
######################
######################
