################################
#      ###       #### ##########
#      # ####   ##..###..##.  ##
#      #    #   # $$   $$  $$ ##
#      # #$ #   #   ##   ## .@##
#      # $. #    # ## ##########
#      # .. #   ##  ##    #### #
#      # $  #   # $$.#    ##. ##
#      #    #   #  $.###### $ ##
#      # ####   ##      .##   ##
#      # #      ####### #### ###
#     ## ############## #### ###
#     #.$ ##   ##   ##.  ##   ##
#     #.$      . $    $ $     ##
#     ##  ##   ##   ##  .##   ##
#      # # ## #### #### ####.###
#    ### # ## #### #### #### ###
#    #   ####  ##   ###  ## $ ##
#    #$   ##  $     ##  $     ##
#  ###  $### $$ # $ ## $$ #   ##
#  #  $ $ ## ..### ### ..#######
#### # ## ## #####.### ###     #
##   # ## ## #  #   ## #       #
## $  $      #  #      #       #
#########.##.#  #   ##.#       #
#       #.####  ########       #
#       #.#                    #
#       #.#                    #
#       #.#                    #
#       #.#                    #
#       ###                    #
################################
