################################
##########      ###########    #
##  ####. #     #.  ###  @#    #
## $.   $ #     #$ $###$$ #    #
##   ##   #     #  .### ###    #
### # ## ##     ## ###   .#    #
### #### ######### ###   .#    #
##   ## $.## $.## $.### # #    #
## $                ### # ######
## .###.$ ##.$ ##.$ ###       ##
# # #### #### #### ######### ###
# # #### #### #### ######### ###
##   ##.  ##   ##  ###.  ##.  ##
##.$   $ $   $    $.  $ $  $ $##
###  ##  .## .###   ##  .##  .##
### #### ## # #### # ## #### ###
### #### #### #### #### #### ###
##   ## $.## $.##.  ## $.##.  ##
## $             $ $       $ $##
## .###.$ ##.$ ##  .##.$ ##  .##
# # #### ######### #### #### ###
### #### #####   # #### #### ###
###.   #     ####   ##  ###  ###
## .   # $  $    .$    $.   $.##
###.   #$# ##  ###  ##   ##   ##
###.   .   ##  ### #### # ## # #
###.   ###  $ ## # #### #### ###
###########  $ ##   ##   ##   ##
#        #   $   .$     $ .   ##
#        #     ###  ##   ##   ##
#        #######################
################################
