###########################
##############  #####     #
###.   #     ####   #     #
## .   # $  $       #     #
###.   #$####  ## $ #     #
###.   .   ##  ### ##     #
###.   # #  $ ####.##     #
######## ##$ $ ##   #     #
##### $  $ $ $ ##   #     #
#   #    #     ##   #     #
#   ############## ##     #
#               ## ########
#               #.      ###
#               #####.$  ##
#                   #.$$ ##
#                   ##  ###
#                ###  # # #
#                # #  # # #
#                # #  # # #
#                # #### # #
#                #      # #
#                # $..  # #
#               ## #$.$ ###
#               #@       ##
#               ## #### ###
#               ###########
###########################
