################################
#    #####                     #
#    #   ##                    #
#    #$   #                    #
#  ###  $##                    #
#  #  $ $ #                    #
#### # ## ######               #
##   # ## ##   #               #
## $  $        #               #
#########.##   #               #
#       #.###.##               #
#       #.### ##################
#       #.## $ ##.$ ##   ##   ##
#       #.     ##.$     $ .   ##
#       #.##   ###  ##   ##   ##
#       ##### ## # # ## ########
#     ##### # # ## #### ##     #
#     #   ##  ###   ##.  #     #
#     #      $.##     $ $#     #
#     #   ## $.##   ##  .#     #
#     ##.#### ####.#### ##     #
#     ## #### #### #### ########
#     # $ ##   ## $ ##       ###
#     #      $      ###### # ###
#     #   ## .###   #    # # ###
#     ##### #########    #.   ##
#                        #.   ##
#                        ### ###
#                        # $$###
#                        #@  ###
#                        #######
################################
