################################
#                    ######    #
#                    ##  @#    #
#                    ##$$ #    #
#                    ## ###    #
#                    #   .#    #
#                    #   .#    #
#                    ## # #    #
#                    ## # ######
#                    ##       ##
#                    ####### ###
#     ###################### ###
#     # $.##   ##   ##   ##   ##
#     #       $ .       $ .   ##
#     #.$ ##   ##   ##   ##   ##
#     ## #### ##################
#    ### # ## ##               #
#    #   ####  ###########     #
#    #$   ##  $          #     #
#  ###  $### $$ ## $.$# ##     #
#  #  $ $ ## ..# #  ..$ #      #
#### # ## ## ### #      #      #
##   # ## ## #   ########      #
## $  $      #                 #
#########.##.#                 #
#       #.####                 #
#       #.#                    #
#       #.#                    #
#       #.#                    #
#       #.#                    #
#       ###                    #
################################
