################################
#                 ##############
#                 #.##.  ##.  ##
#                 #   $ $  $$ ##
#                 # ##  .## .@##
#               ### ############
#     ###########.. #          #
#     #   ##   # $$ #          #
#     #   . $    $  #          #
#     #   ##   ##  ##          #
#     ####### #### ##  ####    #
#          ## #### ##  #  #    #
#          #.  ##   #### $######
#          #$ $       .       ##
#          #  .## $ ##  .$  ####
#          ## #### ##########  #
#           # # ##.#############
#          #  ###   ##   ##   ##
#          # $.##       $ .   ##
#          # $.##   ##   ##   ##
#          ## #### ######### ###
#      ###### #  # #####  ## ###
#      #      #  #  #  #  #   ##
#      # $#$  # #  $$  #  # $ ##
#      # $  $## # $ # $#  # .###
#      ### $ #  #. ### ### #####
######## $ # ####    . ..#     #
##...  # #  $  ###     ###     #
###..      $   #########       #
##...  #########               #
########                       #
################################
