################################
#    ##### #####################
#    #   ### $.##.  ##   ##  ###
#    #$          $ $   $    $.##
#  ###  $###.$ ##  .## .###   ##
#  #  $ $ ### #### ## ###### # #
#### # ## ### #### #      ## # #
##   # ## ## $.###. #     ##. ##
## $  $           $ #     # $ ##
#########.##.$ ##   #     #   ##
#       #.### #### ##     ## ###
#       #.### #### ##  ### # ###
#       #.##  ###.  #  #.##   ##
#       #.   $.  $ $#  #   .$ ##
#       #.##   ##  .#  # ###  ##
#       ####### ## ##### #######
#               ## ###.. #     #
#               #   # $$ #     #
#               #     $  #     #
#               #   ##  ##     #
#               ##.#### ##     #
###########     ## #### ########
##   ## $.#     # $ ##       ###
##        #     #   ###### # ###
## $ ##.$ #     #   #    # # ###
### #### ##     ## ##    #.   ##
###.## # ######### #     #.   ##
##   ##   ##.  ###. #    ### ###
##     .$   $ $   $ #    # $$###
##   ###  ##  .##   #    #@  ###
#####################    #######
################################
