######################
##############       #
###.   #     ###     #
## .   # $  $  #     #
###.   #$# ##  #     #
###.   .   ##  #     #
###.   ###  $ ########
###########  $ ##.  ##
#        #   $   $ $##
#        #     ##  .##
#        #### #### ###
#          ## #### ###
#          ##  ##.  ##
#          #  $  $ $##
#          # $$ #  .##
#          # ..### ###
#          # ##### ###
#          # #  # $.##
#          # #  #.$ ##
#          #.#  #@  ##
#          ###  ######
######################
