###########################
#     ##################  #
#     #   ###.   #     ####
#     #     ..   # $$ $  ##
#     # $ ###.   #$# ##  ##
#     ## ####....    ##  ##
#     ##.####.   # #  $ ###
#     #   ######## ##$ $ ##
#     #   ##### $  $ $ $ ##
#     #   #   #    #     ##
#     ## ##   #############
#      # # ##########     #
#     #  ###   ##   #     #
#     # $.##  $ .   #     #
#     # $.##   ##   #     #
#     ## #### #######     #
# ###  # # ## ##          #
# # #  # # ##  #          #
# # #  # # #  $#          #
# # #### # # $$           #
# #      # # ..#          #
# # $..  # # ###          #
### #$.$ ### #            #
##@          #            #
### #### ###.#            #
##############            #
###########################
