################################
######                         #
##  @#                         #
## $.#                         #
##.$ #                         #
### ##                         #
### ##  ####### ##########     #
##.$ #  #.##   ##   ##   #     #
##.$ #  #   $$     $ .   #     #
###  #  # ##..###   ##   #     #
# # # ### ##### ## #######     #
### ###.. ######## #######     #
##.$ # $$ ##   ##.      ##     #
##.$   $  ## $ ######.$  #     #
###  ##  ### .##    #.$$ #     #
# # # ## ## # ##    ##  ##     #
### #### #### ######### ##     #
## $.##.$ ##   ##   ##   #     #
##   ##.$    $      . $  #     #
##.$ ###  ## .###   ##   #     #
###### ###  # #### #### ##     #
#          ## #### #### #####  #
#          #   ###.   #     ####
#          #      .   # $  $  ##
#          #   ###.   #$# ##  ##
#  ####    ##.####.   .   ##  ##
#  #  #    ## ####.   ###  $ ###
#### $###### $ ###########  $ ##
##.            #        #   $ ##
##  .$  ####   #        #     ##
#########  #####        ########
################################
