################################
######                         #
##  @#                         #
## $.#                         #
##.$ #                         #
######                         #
#                              #
#                              #
#                              #
#                              #
#                              #
#          ##########          #
#          # $.## $.#          #
#          #        #          #
#          #.$ ##.$ #          #
#          ## #### ##          #
#          ## #### #######     #
#          #.  ##.  ## $.#     #
#          #$ $  $ $     #     #
#          #  .##  .##.$ #     #
#          ## #### #### ##     #
#          ## #### #### #####  #
#          #   ###.   #     ####
#          #      .   # $  $  ##
#          #   ###.   #$# ##  ##
#          ##.####.   .   ##  ##
#          ## ####.   ###  $ ###
#          # $ ###########  $ ##
#          #   #        #   $ ##
#          #   #        #     ##
#          #####        ########
################################
