################################
#               #########      #
#               #   ###@########
#               #             ##
#               #   ### #$ #####
#               ##.#### $. #   #
#     ############ #### .. #   #
#     #   ##   ## $ ### $  #####
#     #  $ .                  ##
#     #   ##   ##   ### ########
#     ## ######### ######      #
#      # #      ## ##          #
#      # ####   #   #          #
#      #    #   #   #          #
#      # #$ #   #   #          #
#      # $. #   ##.##  ####    #
#      # .. #   ## ##  #  #    #
#      # $  #   # $ #### $######
#      #    #   #     .       ##
#      # ####   #   ##  .$  ####
#      # #      ## ##########  #
######## #####  ## ##          #
###.   #     ####   #          #
##...  # $$ $       #          #
###.   #$# ##  ## $ #          #
###.....   ##  ### ##  ####    #
###.   # #  $ ####.##  #  #    #
######## ##$ $ ##   #### $######
##### $  $ $ $ ##     .       ##
#   #    #     ##   ##  .$  ####
#   #########################  #
################################
