################################
#      ####                    #
######## ##                    #
##        #                    #
#####  $ ##                    #
#   # .. ##                    #
#   # .$ #################     #
##### $# ###  ###.      ##     #
##           $.######.$  #     #
########@###   #    #.$$ #     #
#      ###### #     ##  ##     #
#     ####### ######### ##     #
#     #   ##.  ##   ##   #     #
#     #     $ $     . $  #     #
#     #   ##  .##   ##   #     #
#     ##.#### ######### ##     #
#     ## #### ######### ########
#     # $ ##.      ###   ##   ##
#     #   ######.$       . $  ##
#     #   #    #.$$ ##   ##   ##
#     #####    ##  #### ########
#       ########## #### #####  #
#       #.## $.###.   #     ####
#       #        ...  # $$ $  ##
#       # ##.$ ###.   #$# ##  ##
#     ### ########.....   ##  ##
#     #.. #     ##.   # #  $ ###
#      $$ #     ####### ##$ $ ##
#     #$  #     #### $  $ $ $ ##
#     #  ##        #    #     ##
#     #####        #############
################################
