################################
#                    ######    #
#                    ##  @#    #
#                    ##$$ #    #
#                    ## ###    #
#                    #   .#    #
#                    #   .#    #
#                    ## # #    #
#                    ## # ######
#                    ##       ##
#                    ####### ###
#               ############ ###
#               # $.##  ### $.##
#               #      $.     ##
#               #.$ ##   ##.$ ##
#               ## #### # ######
######     ##### # # ## ##     #
##.  #     # $.##  ###   #     #
##$ $#     #      $.## $ #     #
##  .#     #.$ ## $.## .##     #
### ##     ####### ## # ##     #
### ##########  ## ## # ## #####
###.   #     #####  ##   ##   ##
## .   # $  $  ##  $  .$   .$ ##
###.   #$# ##  ## $$ ##  ###  ##
###.   .   ##  ## ..### ########
###.   ###  $ ### ##### ##     #
###########  $ ## #  #.  #     #
#        #   $    #  #$ $#     #
#        #     ##.#  #  .#     #
#        ##########  #####     #
################################
