################################
######           #### ##########
##   #          #   ##   ##.  ##
## $ #          #.$   .$   $$ ##
## .##          ##  ###  ## .@##
# # ##          ####### ########
# # ######           ## ########
##   ###. #          #.  ##  ###
##.$    $ #          #$ $   $.##
###  ##   #          #  .##   ##
### #### ##          ## #### # #
### #### ##     ####### #### ###
##.  ##.  #     #  ###.  ##   ##
##$ $  $ $#     # $.  $ $   $ ##
##  .##  .#     #   ##  .## .###
### #### ##     ## # ## ## # ###
### # ## ######### #  # #### ###
###. ##   ##.  ###. ##   ## $.##
## $    $   $ $   $   .$      ##
##   ## .###  .##   ###  ##.$ ##
### ## # ######### #### #### ###
### #### #####   # #### #### ###
###.   #     ####   ## $.##.  ##
## .   # $  $    .$        $ $##
###.   #$# ##  ###  ##.$ ##  .##
###.   .   ##  ### #### #### ###
###.   ###  $ #### #### #### ###
###########  $ ##.  ##.  ##   ##
#        #   $   $ $  $ $   $ ##
#        #     ##  .##  .## .###
#        ################# #####
################################
