################################
######                ###      #
##  @#                # ####   #
## $.#                #    #   #
##.$ #                # #$ #   #
### ##                # $. #   #
### ##          ##### # .. #   #
##.$ #          #   # # $  #   #
##.$ #          #   # #    #   #
###  #          # $ # # ####   #
# # #   ####    ## ## # #      #
### ##  #  #    ##.#### ########
## $.#### $######   ##   ##   ##
##     .                 . $  ##
##.$ ##  .$  ####   ##   ##   ##
### ##########  ## ######### ###
### ############## ##    ### # #
##   ##   ##   ##   #    #   ###
## $                #    #$   ##
## .###   ##   ##   #  ###  $###
# ######.####.####.##  #  $ $ ##
#     ## #### #### ##### # ## ##
#     # $ ## $ ## $ ##   # ## ##
#     #                $  $   ##
#     #   ##   ##   #########.##
#     ###############       #.##
#                           #.##
#                           #.##
#                           #.##
#                           #.##
#                           ####
################################
