################################
#    ##### #####               #
#    #   ###.  #               #
#    #$     $ $#               #
#  ###  $###  .#               #
#  #  $ $ ### ##               #
#### # ## # # ##               #
##   # ## ##   #               #
## $  $     .$ #               #
#########.###  #               #
#       #.### ##               #
#       #.### ###### #####     #
#       #.##.  ###. ##.  #     #
#       #.  $ $   $   $ $#     #
#       #.##  .##   ##  .#     #
#       ##### #### #### ##     #
#     #### ## #### #### ##     #
#     ##. ## $.##.  ## $.#     #
#     # $        $ $     #     #
#     #   ##.$ ##  .##.$ #     #
#     ####### ######### ##     #
#           # #      ## ########
#           # ####   #       ###
#           #    #   ##### # ###
#           # #$ #       # # ###
#           # $. #       #.   ##
#           # .. #       #.   ##
#           # $  #       ### ###
#           #    #       # $$###
#           # ####       #@  ###
#           ###          #######
################################
