###########################
#          #############  #
#          ##.   #     ####
#          #..   # $$ $  ##
#          ##.   #$# ##  ##
#          ##.....   ##  ##
#     #######.   # #  $ ###
#     #   ######## ##$ $ ##
#     #   ##### $  $ $ $ ##
#     #   #   #    #     ##
#     ##.##   ######### ###
#     ## ############## ###
#     # $ ## $.##   ##   ##
#     #            $ .   ##
#     #   ##.$ ##   ##   ##
#     ## ######### #### ###
# ###  # #  ###### #### ###
# # #  # # ##..##   ##   ##
# # #  # # # $$     . $  ##
# # #### # #   ##   ##   ##
# #      #  # #############
# # $..  # ##  ##         #
### #$.$ ### $$.#         #
##@           $.#####     #
### #### ####      .#     #
#####################     #
###########################
