################################
##############  ############## #
###.   #     #### $.##  ####. ##
## .   # $  $          $.   $ ##
###.   #$# ##  ##.$ ##   ##   ##
###.   .   ##  ######## # ## ###
###.   ###  $ ##      # #### ###
###########  $ #     #   ##  ###
#        #   $ #     #.$    $.##
#        #     #     ##  ##   ##
#        #### ##     ## ###### #
#          ## ######### ##     #
#          #.  ##   ## $.#     #
#          #$ $   $      #     #
#          #  .## .###.$ #     #
#          ## ## # #### ##     #
#     ####### #### #### ##     #
#     #   ## $.##  ### $.#     #
#     # $         $.     #     #
#     # .###.$ ##   ##.$ #     #
#      # #### #### # ## ##     #
#     ## #### # ## #### ########
#     #   ###. ###  ##       ###
#     #      $ ##  $###### # ###
#     # $ ##   ## $$     # # ###
#     ## #### ### ..#    #.   ##
#     ##.#### ### ###    #.   ##
#     #   ##  ### #      ### ###
#     #      $.   #      # $$###
#     #   ##   ##.#      #@  ###
#     ######### ###      #######
################################
