###########################
#    ######## #### #### ###
#    #..  ##   ##   ##   ##
#    #    #               #
#    #..  ##   ##   ##   ##
#    #.   ### #### #### ###
#    #..  ### #### #### ###
#    #.   ##   ##   ##   ##
#    # .                  #
#    #..  ##   ##   ##   ##
#    ######## #### #### ###
#          ## #### ###### #
#          #   ##       ###
#                         #
#          #   ##       ###
#          ## ######### ###
# ##### ## ## ##########  #
# #      # #   ##     @#  #
# #      #      # $#$ ##  #
# #      # #   ## $  $#   #
# #      # ## ####$ $ #   #
### # ## # ## ### $ # #####
##  # ## ###   ## $  $  ###
#                $  $   ###
##### ## ###   ############
############# ##          #
###########################
