## #### # 
#    #  # 
      $  $
#### #####
   ##     
 ###### # 
##@.### ##
#...#     
#...### ##
#...######
