##############
#     ##     #
#  A      a  #
#     ##     #
## ###### ####
## ###### ####
#     ##     #
#            #
#     ##     #
##############
