+++++++++++++++++++++++++
++++++++++     ++ + +  ++
+    A  A/   ++   + +0aa+
++ ++ +  +++++ ++ + +aaa+
++ ++ + +++  AA++ + +aaa+
+ + A A  ++      A+ +aaa+
+ ++A  ++++ A A++ + +aaa+
+  +  A+  ++++    + +aaa+
+  +   +     + + A+ +aa++
+  +++++     ++++/+ +++++
+   +
+ +++++    +/++++         +/+
+ +   +    +A + +        ++ +
+ +A  +    +    ++++   ++   +
+++  A++   + ++A A +++++ ++ +
+  A A +   +A      ++  AA++ +
++ + ++ +  + ++AA  ++      A+
+  + ++ ++ + ++ +++++ A A++ +
+A  A    /   +   ++   ++++    +
++++++++++ + ++        + + A+
+          +/+         ++++/+
+     +/+  +/++++     +++++ +
+    ++ +  +A + +     +   + +
+  ++   +  +    ++++  +A  + +
++++ ++ +  + ++A A ++++  A+++
+  AA++ +  +A      ++  A A ++
+      A+  + ++AA  +++ + ++ +
+ A A++ +  + ++ +++++  + ++ +
++++    +  +   ++   /A  A    /+
+  + + A+  + ++     +++++++++
+++++++++++++++++++++++++++++
