+++++++++++++++++++++++++++
+++ ++++ ++++ ++    +++++ +
++   ++   ++   +    +   + +
+                   +A  + +
++   ++   ++   ++++++  A+++
+++ ++++ ++++ +++++  A A ++
+++ ++++ ++++ +++++ + ++ ++
++   ++   ++   ++   + ++ ++
+                 A  A  0 +
++   ++   ++   ++++++++++++
+++ ++++ ++++ ++          +
+++ +++++++++ ++++ ++++ +++
++   ++        ++   ++   ++
+     +        +          +
++   ++   +++++++   ++   ++
+++ +++       ++++ ++++ +++
+++ ++++ +++++++++ ++++ +++
++   +++      +++   ++   ++
+     +       ++          +
++   ++     + +++   ++   ++
+++ +++++++++ ++++ ++++ +++
+ ++++++++ ++ ++++ ++++ +++
+++      +++   ++   ++   ++
+   aaaa  +               +
++  a a   ++   ++   ++   ++
+++++++++++++ ++++ ++++ +++
+++++++++++++++++++++++++++
