###########################
#    ##### ## #### ##     #
#    #   # #   ##   #     #
#    #$  #                #
######  $###   ##   #     #
####  $ $ ### #### ##     #
#### # ## ### #### #### ###
##   # ## ##   ##   ##   ##
#  $  $  @                #
############   ##   ##   ##
#          ## #### #### ###
#     ## #### ##     ## ###
#     #   ##   #     #   ##
#                         #
#     #   ##   #     #   ##
#     ## #### ##     ## ###
### #### ###########      #
##   ##   ##       ##     #
#                         #
##   ##   ##       ##     #
### #### ############     #
### #### #### ## ######## #
##   ##   ##   ###    ..###
#                      ..##
##   ##   ##   ##     .. ##
### #### #### #############
###########################
