##########
#  A@   a#
## #### ##
## #### ##
#        #
##########
