###########################
#          ## #### #### ###
############   ##   ##   ##
###   $  $                #
###  $  $ ##   ##   ##   ##
##### # $ ### #### #### ###
#   # $ $#### #### ## # ###
#   #$  $ ##   ##   ### ###
#  ## $#$ #          #    #
#  #@     ##   ##   ##   ##
#  ########## #### ###   ##
#          ## ## # ###   ##
#          #   ### ###   ##
#               #        ##
#          #   ##   ##   ##
#          ## ###   ### ###
#          ## ###   ### ###
#          #   ##   ### ###
#                   ##   ##
#          #   ##   ##   ##
#          ## #### ###...##
#     ## #### #### ###...##
#     #   ##   ##   ##...##
#                    #.#.##
#     #   ##   ##   #######
#     ## #### #### ########
###########################
