+++++++++++++++++++++++++++
+          ++ ++++ ++++ +++
++++++++++++   ++   ++   ++
+++   A  A                +
+++  A  A ++   ++   ++   ++
+++++ + A +++ ++++ ++++ +++
+   + A A++++ ++++ ++ + +++
+   +A  A ++   ++   +++ +++
+  ++ A+A +          +    +
+  +0     ++   ++   ++   ++
+  ++++++++++ ++++ +++   ++
+          ++ ++ + +++   ++
+          +   +++ +++   ++
+               +        ++
+          +   ++   ++   ++
+          ++ +++   +++ +++
+          ++ +++   +++ +++
+          +   ++   +++ +++
+                   ++   ++
+          +   ++   ++   ++
+          ++ ++++ +++aaa++
+     ++ ++++ ++++ +++aaa++
+     +   ++   ++   ++aaa++
+                    +a+a++
+     +   ++   ++   +++++++
+     ++ ++++ ++++ ++++++++
+++++++++++++++++++++++++++
