##############
#     ##     #
#  A     hola#
#     ##     #
## ###### ####
## ###### ####
#     ##     #
#            #
#     ##     #
##############
