+++++++++++++++++++++++++++
+    +++++ ++ ++++ ++     +
+    +   + +   ++   +     +
+    +A  +                +
++++++  A+++   ++   +     +
++++  A A +++ ++++ ++     +
++++ + ++ +++ ++++ ++++ +++
++   + ++ ++   ++   ++   ++
+  A  A  0                +
++++++++++++   ++   ++   ++
+          ++ ++++ ++++ +++
+     ++ ++++ ++     ++ +++
+     +   ++   +     +   ++
+                         +
+     +   ++   +     +   ++
+     ++ ++++ ++     ++ +++
+++ ++++ +++++++++++      +
++   ++   ++       ++     +
+                         +
++   ++   ++       ++     +
+++ ++++ ++++++++++++     +
+++ ++++ ++++ ++ ++++++++ +
++   ++   ++   +++    aa+++
+                      aa++
++   ++   ++   ++     aa ++
+++ ++++ ++++ +++++++++++++
+++++++++++++++++++++++++++
