##############
#     ##     #
#  A         #
#     ##     #
## ###### ####
#### #### ####
#     ##     #
#aloh        #
#     ##     #
##############
