+++++++++++++++++++++++++++
+    ++++++++ ++++ ++++ +++
+    +aa  ++   ++   ++   ++
+    +    +               +
+    +aa  ++   ++   ++   ++
+    +a   +++ ++++ ++++ +++
+    +aa  +++ ++++ ++++ +++
+    +a   ++   ++   ++   ++
+    + a                  +
+    +aa  ++   ++   ++   ++
+    ++++++++ ++++ ++++ +++
+          ++ ++++ ++++++ +
+          +   ++       +++
+                         +
+          +   ++       +++
+          ++ +++++++++ +++
+ +++++ ++ ++ ++++++++++  +
+ +      + +   ++     0+  +
+ +      +      + A+A ++  +
+ +      + +   ++ A  A+   +
+ +      + ++ ++++A A +   +
+++ + ++ + ++ +++ A + +++++
++  + ++ +++   ++ A  A  +++
+                A  A   +++
+++++ ++ +++   ++++++++++++
+++++++++++++ ++          +
+++++++++++++++++++++++++++
