  #####    # #  ######## 
  #   #   ## ## #      # 
  #$  #   #     #      # 
###  $##  #     #      # 
#  $ $ #  ##### #      # 
## # ## # ## #### # ## # 
#  # ## ###    #  # ## ##
 $  $  @                 
############## #### ## ##
             ############
  ### ####  #############
  #   #     #      #    #
  #   #     #            
###   #   ###      #    #
#     #   #        #    #
 # # ## # #        #    #
## ###  # #        #    #
#                  #    #
#    #### ###############
#########################
 # # ## ## # #  ######## 
## ###    ## #### .   .##
#         #       .  .. #
#    #### #    #      . #
#####   #################
