 # #        #####   
## #######  #   #   
#        #  #$  #   
#        ####  $##  
###########  $ $ #  
## # ## # ## # 
#  # ## ###  ##
 $  $       #@..#
###########...#
          #...#
#...# # #      
#...### #######
#...##        #
#..###        #
#### ##########
     
     
     
     
     
