+++++++++++++++++++++++++++
+          ++ ++          +
++++++++++++   +          +
+++   A  A                +
+++  A  A ++   +          +
+++++ + A +++ ++          +
+   + A A++++ ++          +
+   +A  A ++   +          +
+  ++ A+A +               +
+  +0     ++   +          +
+  ++++++++++ ++          +
+     ++ ++++ ++          +
+     +   ++   +          +
+                         +
+     +   ++   +          +
+     ++ ++++ ++          +
+++ ++++ ++++++ ++++++    +
++   ++       +++  a +    +
+                   a+    +
++   ++       +++  aa+    +
+++ +++++++++ +++    +    +
+ + +           +  aa+    +
+++ +++++++     +   a+    +
++        +     +  aa+    +
++        +     +  aa+    +
+++++++++++     ++++++    +
+++++++++++++++++++++++++++
