++++++++++++++++++++++++
+   ++   ++   ++   ++ 0+
+   + a    a    a      +
+   ++   ++   ++   ++  +
+++++++ ++++ ++++ ++++ +
++ ++++ ++++ ++++ ++++ +
+ a ++   ++   ++   ++ a+
+     a    a    a      +
+   ++   ++   ++   ++  +
++ ++++ ++++ ++++ ++++ +
++ ++++ ++++ ++++ ++++ +
+   ++   ++   ++   ++  +
+  a    a       a    a +
+   ++   ++ a ++   ++  +
++ ++++ ++++ ++++ ++++ +
++ ++++ ++++ ++++ ++++ +
+   ++ a ++   ++   ++  +
+  a       a    a      +
+   ++   ++   ++   ++  +
++ ++++ ++++ ++++ ++++ +
++ ++++ ++++ ++++ ++++++
+   ++   ++ a ++ a ++ a+
+a    a             +  +
+   ++   ++   ++   ++  +
++++++++++++++++++++++++
