+++++++ ++ + ++++ ++ ++++
+    +     +  ++    ++  +
           +        +  a+
+    ++++ ++  +++++ +0a +
+++++   +++   +   +++   +
 + +      +   ++   ++  a+
++ ++++++++   ++   ++  a+
+        +++   +   ++ aa+
+        + +  ++   +++  +
++++++++++ + ++++ ++ + ++
 +   ++ + ++ + ++ ++++ ++
 +   +  + +  + +        +
 +                       
 +   ++++ ++++ ++++   +++
 ++++++++++++++   +++++  
  +++++   ++++ +       ++
  +   +      + +       ++
  +A  +      + ++++    ++
+++  A++     +    +    ++
+  A A +     +    ++++ ++
++ + ++ + ++ + +++++++++ 
+  + ++ ++++ +++       ++
 A  A                    
++++++++++++ +++       ++
          +++++++++++++++
