####### ## # #### ## ####
#    #     #  ##    ##  #
           #        #  .#
#    #### ##  ##### #@. #
#####   ###   #   ###   #
 # #      #   ##   ##  .#
## ########   ##   ##  .#
#        ###   #   ## ..#
#        # #  ##   ###  #
########## # #### ## # ##
 #   ## # ## # ## #### ##
 #   #  # #  # #        #
 #                       
 #   #### #### ####   ###
 ##############   #####  
  #####   #### #       ##
  #   #      # #       ##
  #$  #      # ####    ##
###  $##     #    #    ##
#  $ $ #     #    #### ##
## # ## # ## # ######### 
#  # ## #### ###       ##
 $  $                    
############ ###       ##
          ###############
