###########################
### #### #### ##    ##### #
##   ##   ##   #    #   # #
#                   #$  # #
##   ##   ##   ######  $###
### #### #### #####  $ $ ##
### #### ###### ### # ## ##
##   ##       ###   # ## ##
#                 $  $  @ #
##   ##       #############
### ######### ##          #
### #### #### #### #### ###
##   ##   ##   ##   ##   ##
#                         #
##   ##   ##   ##   ##   ##
### #### #### #### #### ###
### #### #### #### ###### #
##   ##   ##   ##       ###
#                         #
##   ##   ##   ##       ###
### #### #### ######### ###
# ########  # #      ## ###
###   .  #### ########   ##
#  .     .##        #     #
## ..    .##        ##   ##
####################### ###
###########################
