##############
#     ##     #
#  A      a  #
#     ##     #
## ###### ####
## ###########
#     ##     #
#         a  #
#     ##     #
######### ####
