  +++++    + +  ++++++++ 
  +   +   ++ ++ +      + 
  +A  +   +     +      + 
+++  A++  +     +      + 
+  A A +  +++++ +      + 
++ + ++ + ++ ++++ + ++ + 
+  + ++ +++    +  + ++ ++
 A  A  0                 
++++++++++++++ ++++ ++ ++
             ++++++++++++
  +++ ++++  +++++++++++++
  +   +     +      +    +
  +   +     +            
+++   +   +++      +    +
+     +   +        +    +
 + + ++ + +        +    +
++ +++  + +        +    +
+                  +    +
+    ++++ +++++++++++++++
+++++++++++++++++++++++++
 + + ++ ++ + +  ++++++++ 
++ +++    ++ ++++ a   a++
+         +       a  aa +
+    ++++ +    +      a +
+++++   +++++++++++++++++
