###################
## #######  #   # #
#        #  #$  # #
#        ####  $###
###########  $ $ ##
## # ## # ## #
#  # ## ###  #
#$  $       #@.#
###########..#
#         #..#
#...# # #    #
#...### ######
#...##       #
#..###       #
#### #########
#  #
#  #
#  #
#  #
####
