###########################
#          ## ##          #
############   #          #
###   $  $                #
###  $  $ ##   #          #
##### # $ ### ##          #
#   # $ $#### ##          #
#   #$  $ ##   #          #
#  ## $#$ #               #
#  #@     ##   #          #
#  ########## ##          #
#     ## #### ##          #
#     #   ##   #          #
#                         #
#     #   ##   #          #
#     ## #### ##          #
### #### ###### ######    #
##   ##       ###  . #    #
#                   .#    #
##   ##       ###  ..#    #
### ######### ###    #    #
# # #           #  ..#    #
### #######     #   .#    #
##        #     #  ..#    #
##        #     #  ..#    #
###########     ######    #
###########################
