+++++++++++++++++++++++++++
+    ++++++               +
+    +    +               +
+    +    +               +
+    + a  +               +
+    +a   +               +
+    +    +++ ++++ +      +
+    + a  ++   ++  +      +
+    +aa           ++     +
+    + a  ++   ++   +     +
+    ++++++++ +++   +     +
+               +   +     +
+               +  ++     +
+                  +      +
+               +  +      +
+               ++ +      +
+                + ++++   +
+                +  +++   +
+                +A +++   +
+                +    +   +
+                + ++ +++++
+                +A  A A ++
+                + ++    ++
+                + ++AA  ++
+                +0   +++++
+                + ++++   +
+++++++++++++++++++++++++++
