++ ++++ + 
+    +  + 
      A  A
++++ +++++
   ++     
 ++++++ + 
++0a+++ ++
+aaa+     
+aaa+++ ++
+aaa++++++
