###########################
#    ######               #
#    #    #               #
#    #    #               #
#    # .  #               #
#    #.   #               #
#    #    ### #### #      #
#    # .  ##   ##  #      #
#    #..           ##     #
#    # .  ##   ##   #     #
#    ######## ###   #     #
#               #   #     #
#               #  ##     #
#                  #      #
#               #  #      #
#               ## #      #
#                # ####   #
#                #  ###   #
#                #$ ###   #
#                #    #   #
#                # ## #####
#                #$  $ $ ##
#                # ##    ##
#                # ##$$  ##
#                #@   #####
#                # ####   #
###########################
