###########################
### #### #### ##    ##### #
##   ##   ##   #    #   # #
#                   #$  # #
##   ##   ##   ######  $###
### #### #### #####  $ $ ##
### #### #### ##### # ## ##
##   ##   ##   ##   # ## ##
#                 $  $  @ #
##   ##   ##   ############
### #### #### ##          #
### ######### #### #### ###
##   ##        ##   ##   ##
#     #        #          #
##   ##   #######   ##   ##
### ###       #### #### ###
### #### ######### #### ###
##   ###      ###   ##   ##
#     #       ##          #
##   ##     # ###   ##   ##
### ######### #### #### ###
# ######## ## #### #### ###
###      ###   ##   ##   ##
#   ....  #               #
##  . .   ##   ##   ##   ##
############# #### #### ###
###########################
