+++++++++++++++++++++++++++
+          ++ ++ + ++     +
+          +   ++   +     +
+            A   aA       +
+          + a++++  +     +
+           + ++++ ++     +
+ + ++ + ++++ +  + ++++   +
++   ++   +++a +++a   ++  +
+ aA   aA    A  +  A+A +  +
+++  +++  ++   ++a     +  +
+++ ++++ ++++ +++++  +++  +
+++ + ++  ++    ++++++    +
+++a ++ AAa+              +
+  A     Aa+++++          +
++   +++      a+          +
+++ +++++++++ ++          +
+++ +++++++++ + ++ ++     +
++       ++++a ++   +     +
++++++ + ++  A    A       +
+    + + +++   ++ a++     +
+    +a   +++ ++ + ++     +
+    +a   +++ + ++ +      +
+    +++ ++++a +++a +     +
+    + AA++  A    A       +
+    +0  +++   ++   +     +
+    ++++++++ ++++ ++     +
+++++++++++++++++++++++++++
